...........................................................................
.....T.....................................................................
.....T.....................................................................
.....T.................................T...................................
.....T.....................................................................
T....T................................................T...................T
T....T....................................................................T
T....T....................................................................T
T....T....................................................................T
T....T..........................................T.........................T
T....T....................................................................T
T....T....................................................................T
T....T.......................................................T............T
T....T.......................................................T............T
T....T.......................................................T............T
T............................................................T............T
T............................................................T............T
T............................................................T............T
T............................................................T............T
T............................................................T............T
T............................T............................................T
T...........................TT............................................T
T..........................TTT............................................T
T.......................TTTTTT.................TTTTTTTT...................T
T......................TTTTTTT............................................T
T..........T..........TTTTTTTT........TT..................................T
T..........TT........TTTTTTTTT............................................T
TTT...TTTTTTTTTTTTTTTTTTTTTTTTTTTTTTTTTTTTTTTTTTTTTTTTTTTTTTTTTTTTTTTTTTTTT
..T........................................................................
..T........................................................................
..T........................................................................
..T........................................................................
..T........................................................................
..T........................................................................
..T......................................................................T.
..T......................................................................T.
..T......................................................................T.
..T......................................................................T.
..T......................................................................T.
..T....................1234TT!@#$........................................T.
..T..................slTTTTTTTTTTop......................................T.
..T.................RTTTTTTTTTTTTTTL.....................................T.
..T...............slTTTTTTTTTTTTTTTTop........s34T!@p......................
..T...........1234TTTTTTTTTTTTTTTTTTTT!@#$.12lTTTTTTTo#$...................
..TTTTTTTTTTTTTTTTTTTTTTTTTTTTTTTTTTTTTTTTTTTTTTTTTTTTTTTTTTTTTTTTTTTTTTTTT