000100000001
000010000010
000001000100
000000101000
000000010000
000000101000
000001000100
000010000010
000100000001