000000000000000000000000000000000000000000000000000000000000000000000000000
000000000000000000000000000000000000000000000000000000000000000000000000000
000000000000000000000000000000000000000000000000000000000000000000000000000
000000000000000000000000000000000000000000000000000000000000000000000000000
000000000000000000000000000000000000000000000000000000000000000000000000000
100000000000000000000000000000000000000000000000000000000000000000000000001
100000000000000000000000000000000000000000000000000000000000000000000000001
100000000000000000000000000000000000000000000000000000000000000000000000001
100000000000000000000000000000000000000000000000000000000000000000000000001
100000000000000000000000000000000000000000000000000000000000000000000000001
100000000000000000000000000000000000000000000000000000000000000000000000001
100000000000000000000000000000000000000000000000000000000000000000000000001
100000000000000000000000000000000000000000000000000000000000010000000000001
100000000000000000000000000000000000000000000000000000000000010000000000001
100000000000000000000000000000000000000000000000000000000000010000000000001
100000000000000000000000000000000000000000000000000000000000010000000000001
100000000000000000000000000000000000000000000000000000000000010000000000001
100000000000000000000000000000000000000000000000000000000000010000000000001
100000000000000000000000000000000000000000000000000000000000010000000000001
100000000000000000000000000001000000000000000000000000000000010000000000001
100000000000000000000000000011000000000000000000000000000000000000000000001
100000000000000000000000000111000000000000000000000000000000000000000000001
100000000000000000000000001111000000000000000000000000000000000000000000001
100000000000000000000000111111000000000000000001111111100000000000000000001
100000000000000000000001111111000000000000000000000000000000000000000000001
100000000000100000000011111111000000000000000000000000000000000000000000001
100000000001100000000111111111000000000000000000000000000000000000000000001
110111111111111111111111111111111111111111111111111111111111111111111111111
0101
0101
0101
0101
0101
0101
0101
0101
0111